1,Room1,0,2,0,0
2,Room2,0,0,5,1
3,Room3,0,0,6,0
4,Room4,0,5,7,0
5,Room5,2,6,8,4
6,Room6,3,0,9,5
7,Room7,4,0,0,0
8,Room8,5,9,0,0
9,Room9,6,0,0,8
